NO ./texture/north_text.xpm
SO ./texture/south_text.xpm
WE ./texture/west_text.xpm
EA ./texture/east_text.xpm
F 103,145  ,125
C 225,30,0

        1111111111111111111111111
        1000000000110000000000001
        1011000001110000000000001
        1111111111111111111111111             
        1111111011111111111111111
        1001000000000000000000001
111111111011000001110000000000001
100000000011000001110111111111111
111101111111110111000000100011111
11110111111111011101010010001
11000000110101011100000010001
1000000000000001100000010001
10000000000000001101010010001
1100000111010101111101111000111
11110111 111S101 101111010001
11111111 1111111 111111111111
