NO ./texture/north_text
SO ./texture/south_text
WE ./texture/west_text
EA ./texture/east_text

F 220,100,0
C 225,30,0

1110111
1000001
1000001
1111111